7 x 7
dynamic
3 5 x 5
thanksgiving
x x x x x x x
x p - c x x x
x x x - x x x
x c - d - c x
x x x - x x x
x x x c x x x
x x x x x x x