7 x 7
dynamic
1 2 x 2
halloween
x x x x x x x
x p - c x d x
x - x x x - x
x - x - - c x
x - x - x x x
x - - - x x x
x x x x x x x